X0XX0X0X0X
XX0XXX0XXX
XXXXX0X0XX
X00XXX0XXX
X00XFXXXXX
XXXXXXXX0X
XX0X000X0X